Skip to content    International Symposium on Field-Programmable Gate Arrays   

 ISFPGA 2025 
  Attend | Registration 
  Travel 
  Calls | Call For Papers 
  Call for Workshops & Tutorials 
  Committees 
  Diversity 
  Archive 

 Committees  

 Organizing Committee:  
  
 General Chair | Andrew Putnam | Microsoft 
 Program Chair | Jing Li | University of Pennsylvania 
 Publications Chair | Grace Zgheib | Intel 
 Finance Chair | Zhiru Zhang | Cornell University 
 Workshop Chair | Dustin Richmond | UC Santa Cruz 
 Publicity and Website Chair | Aman Arora | Arizona State University 
 Artifact Evaluation Co-Chair | Miriam Leeser | Northeastern University 
 Artifact Evaluation Co-Chair | Suhaib Fahmy | KAUST 
 Artifact Evaluation Co-Chair | Sitao Huang | UC Irvine 
  
 Program Committee:  
  
 First | Last | Affiliation 
 Aaron | Landy | Microsoft 
 Adrian | Caulfield | Microsoft Research 
 Ali | Akoglu | University of Arizona 
 Alireza | Kaviani | AMD 
 Aman | Arora | Arizona State University 
 Andre | DeHon | University of Pennsylvania 
 Andrew | Ling | Groq 
 Andrew | Putnam | Microsoft 
 Archit | Gajjar | Artificial Intelligence Research Lab (AIRL), Hewlett Packard Labs 
 Aydin | Aysu | North Carolina State University 
 Caiwen | Ding | University of Minnesota Twin Cities 
 Christophe | Bobda | University of Florida 
 Cong (Callie) | Hao | Georgia Institute of Technology 
 Dana Livingston | How | Rapid Silicon 
 David | Pan | The University of Texas at Austin 
 David Barrie | Thomas | University of Southampton 
 Deming | Chen | UIUC 
 Derek | Chiou | UT Austin/Microsoft 
 Dinesh | Gaitonde | AMD 
 Dirk | Stroobandt | Ghent University, Belgium 
 Dustin | Richmond | University of California, Santa Cruz 
 Eriko | Nurvitadhi | MangoBoost, Inc. 
 Gabriel | Weisz | AMD 
 George A | Constantinides | Imperial College 
 Grace | Zgheib | Intel 
 Greg | Stitt | Quantlab (w/ courtesy appointment at University of Florida) 
 Guojie | Luo | Peking University 
 Guy | Lemieux | University of British Columbia 
 Hamish | Fallside | Microchip Corporation 
 Hayden | So | University of Hong Kong 
 Heather | Quinn | AFRL 
 Ilya | Ganusov | Altera 
 James C. | Hoe | MangoBoost and Carnegie Mellon University 
 Jason | Anderson | University of Toronto 
 Jason | Cong | UCLA 
 Jeff | Chromczak | Altera 
 Jeff | Goeders | BYU 
 Jing "Jane" | Li Chai | University of Pennsylvania 
 Jonathan W | Greene | UC Berkeley / Cambios Computing 
 Jürgen Teich | Friedrich-Alexander | Universität Erlangen-Nürnberg (FAU) 
 Kambiz | Rahimi | Microsoft 
 Kan | Shi | Institute of Computing, Chinese Academy of Sciences 
 Ken | Eguro | Microsoft 
 Kenji | Kise | Tokyo Institute of Technology 
 Kia | Bazargan | University of Minnesota 
 Lana | Josipovic | ETH Zurich 
 Lizy | Kurian | John UT Austin 
 Louis-Noel | Pouchet | Colorado State University 
 Marilyn | Wolf | University of Nebraska Lincoln 
 Martin | Langhammer | Altera, Imperial College London 
 Maya | Gokhale | LLNL 
 Michael | Adler | Altera 
 Mike | Wirthlin | BYU 
 Miriam | Leeser | Northeastern University 
 Mirjana | Stojilovic | EPFL 
 Mohamed | Abdelfattah | Cornell University 
 Nachiket | Kapre | University of Waterloo 
 Nithin | George | Intel 
 Nithin | Dev | Bandakka Synopsys Inc. 
 Oliver | DIessel | The University of New South Wales 
 Paul | Chow | University of Toronto 
 Peipei | Zhou | Brown University 
 Peter | Cheung | Imperial College London 
 Philip | Brisk | UC Riverside 
 Philip | Leong | The University of Sydney 
 Ray | Cheung | City University of Hong Kong 
 Russ | Tessier | University of Massachusetts Amherst 
 Ryan | Kastner | UC San Diego 
 Sang-Woo | Jun | UC Irvine 
 Satwant | Singh | Lattice Semiconductor Corporation 
 Scott | Hauck | University of Washington 
 Scott | Weber | Altera 
 Shijie | Zhou | Microsoft 
 Shouyi | Yin | Tsinghua University 
 sinan | kaptanoglu | Microchip Corporation 
 Sitao | Huang | University of California 
 Skand | Hurkat | Microsoft 
 Stefan | Nikolić | University of Novi Sad 
 Stephen | Neuendorffer | AMD 
 Steve | Trimberger | The Trimberger Family Foundation 
 Steve | Wilton | University of British Columbia 
 Suhaib | Fahmy | KAUST 
 Sundararajarao | Mohan | AMD 
 Tao | Wei | Clemson University 
 Vaughn | Betz | University of Toronto 
 Viktor | Prasanna | University of Southern California 
 Wayne | Luk | Imperial College 
 Wei | Zhang | Hong Kong University of Science and Technology 
 Wenyi | Feng | AMD 
 Yajun | Ha | ShanghaiTech University 
 Young-kyu | Choi | Inha University 
 Yu | Wang | Tsinghua Univ. 
 Yun | Eric | Liang Peking University 
 Zhenman | Fang | Simon Fraser University 
 Zhiru | Zhang | Cornell University 
  
 Artifact Evaluators:  
  
 Coming Soon |  
  
 Additional Reviewers:  
  
 Coming Soon |  

 © All right reserved  
 Event Star by Acme Themes    

 ×